XXXXXXXXXXXXXXXXXXXXXXXXXXXXXXXXXXX
X              _           XXXXXXXX
X  _                       XXXXXXXX
X        XXXXXXXXXXXXX     XXXXXXXX
X        X...........X_    XXXXXXXX
X   :    X...........X   _ XXXXXXXX
X        X...........X     XXXXXXXX
X    _   X...........X_    XXXXXXXX
X        X...........X     XXXXXXXX
X        X...........X  _  XXXXXXXX
X_       X...........X     XXXXXXXX
X  :     X...........X_  : XXXXXXXX
X       _XXXXXXXXXXXXX     XXXXXXXX
X   _              _     _ XXXXXXXX
XWWWWWWWWWWWWW  WWWWWWWWWWWWWWWWWWWWWWWWWX
XWWWWWWWWWWWWW  WWWWWWWWWWWWWWWWWWWWWWWWWX
XWWWWWWWWWWWWW  WWWWWWWWWWWWWWWWWWWWWWWWWX
XXXX              XXXXXXXXXXXXXXXXXXXXXXXX
XXXX         _    XXXXXXXXXXXXXXXXXXXXXXXX
XXXX : XXXXXXXXXXXXXXXXXX    :      XXXXXX
XXXX   XXXXXXXXXXXXXXXXXX           XXXXXX
XXXX   XXXXXXXXXXXXXXXXXX         _ XXXXXX
XXXX                                XXXXXX
XXXX:  _        :_                  XXXXXX
XXXXX       _               :_      XXXXXX
XXXXXXXXXX      XXXXXXXXXXXXXXXXXXXXXXXXXX
XXXXXXXXXX      XXXXXXXXXXXXXXXXXXXXXXXXXX
XXXXXXXXXX      XXXXXXXXXXXXXXXXXXXXXXXXXX
XXXXXXXXXX      XXXXXXXXXXXXXXXXXXXXXXXXXX
XXXXXXXXXX      XXXXXXXXXXXXXXXXXXXXXXXXXX
XXXXXXXXXXXXXXXXXXXXXXXXXXXXXXXXXXXXXXXXXX
